1111111111
1000110001
1010100101
1010001101
1000011001
1110001101
1001000101
1011110111
1000000001
1111111111