1111111111
1000110001
1010011101
1001001001
1101101011
1001001001
1011011101
1001001001
1101101011
1111111111

